{
  "width": 20,
  "height": 15,
  "layout": [
    ["■", "■", "■", "■", "■", "■", "■", "■", "■", "■", "■", "■", "■", "■", "■", "■", "■", "■", "■", "■"],
    ["■", " ", " ", " ", " ", " ", " ", " ", " ", " ", " ", " ", " ", " ", " ", " ", " ", " ", " ", "■"],
    ["■", " ", " ", " ", " ", " ", " ", " ", " ", " ", " ", " ", " ", " ", " ", " ", " ", " ", " ", "■"],
    ["■", " ", " ", " ", "H", " ", " ", " ", " ", "C", " ", " ", " ", " ", " ", " ", " ", " ", " ", "■"],
    ["■", " ", " ", " ", " ", " ", " ", " ", " ", " ", " ", " ", " ", " ", " ", " ", " ", " ", " ", "■"],
    ["■", " ", " ", " ", " ", " ", " ", " ", " ", " ", " ", " ", " ", " ", " ", " ", " ", " ", " ", "■"],
    ["■", " ", " ", " ", " ", " ", " ", " ", " ", " ", " ", " ", " ", " ", " ", " ", " ", " ", " ", "■"],
    ["■", " ", " ", " ", " ", " ", " ", " ", " ", " ", " ", " ", " ", " ", " ", " ", " ", "G", " ", "■"],
    ["■", " ", " ", " ", " ", " ", " ", " ", " ", " ", " ", " ", " ", " ", " ", " ", " ", " ", " ", "■"],
    ["■", " ", " ", " ", " ", " ", " ", " ", " ", " ", " ", " ", " ", " ", " ", " ", " ", " ", " ", "■"],
    ["■", " ", " ", " ", " ", " ", " ", " ", " ", " ", " ", " ", " ", " ", " ", " ", " ", " ", " ", "■"],
    ["■", " ", " ", " ", "P", " ", " ", " ", "A", " ", " ", " ", " ", "W", " ", " ", " ", " ", " ", "■"],
    ["■", " ", " ", " ", " ", " ", " ", " ", " ", " ", " ", " ", " ", " ", " ", " ", " ", " ", " ", "■"],
    ["■", " ", " ", " ", " ", " ", " ", " ", " ", " ", " ", " ", " ", " ", " ", " ", " ", " ", " ", "■"],
    ["■", "■", "■", "■", "■", "■", "■", "■", "■", "■", "■", "■", "■", "■", "■", "■", "■", "■", "■", "■"]
  ],
  "playerStart": {
    "x": 1,
    "y": 7
  }
}
